111111111111111
101010P00101001
1C00010110C0101
110100001011101
101101100010101
100000001010101
101111101111101
100100000000001
110111111111111
100010000010101
111010101010001
100010101010101
101111101010101
1000C00010001E1
111111111111111
